EA                                                       fdsfdsfsd
NO fdsfs     ffsdfds

WE                                       fsdfdsfsd g

jdfkhdsfjksd

SO       gdfgdf

F 255,    255,     254
C 0, 10,    		0

		1111111111111111111111111
		1000000000110000000000001
		1011000001110000000000001
		1001000000000000000000001
111111111011000001110000000000001
100000000011000001111111111111111
11110111111111011100000010001
11110111111111011101010010001
11000000110101011100000010001
10000000000000001100000010001
10000000000000001101010010001
11000001110101011111011110N0111
1111011  111101011011  11010001
1111111  111111111111  11111111