EA                                                       fdsfdsfsd
NO 				   			 	 	 	 	 			fdsfs     ffsdfds

WE                 			              fsdfdsfsd g

jdfkhdsfjksd

SO       gdfgdf

F 255,    255,     254
C 0, 10,    		0

111111
1000N1
100001
100001
111111