EA                                                       fdsfdsfsd
NO 				   			 	 	 	 	 			fdsfs     ffsdfds

WE                 			              fsdfdsfsd g

jdfkhdsfjksd

SO       gdfgdf

F 255,    255,     254
C 0, 10,    		0

1111111
1000001
1N00001
1000001
1111111